3 13 31
###############################
#p   * *  *  2 *   *  * * *   #
# # # #*# # #*# # # # #*#*#*# #
#  *     **   * 1    *   *  * #
# # # # # #*# # #*#*# # # # #*#
#      *  5 x **  *  *     4  #
# # # # # # # # # #*# #*# # # #
#       *  *  *b     *        #
# # # # #*# # # #*#*# # # # # #
#  1  **  *       *           #
# #*# # # # # # #*# # # # # # #
#           *   *  *     3    #
###############################