1 13 31
###############################
#p  s* *       * 2 *  * * *   #
# # # #*# # #*# # # # #*#*#*# #
#  *   1 **   *  1   * 2 * f* #
# # # # # #*# # #*#*# # # # #*#
# x    *    x **  *  *   1    #
# # # # # # # # # #*# #*# # # #
#*         *  *b     *        #
# # # # #*# # # #*#*# # # # # #
#*    **  *       *           #
# #*# # # # # # #*# # # # # # #
#          1*   *  *          #
###############################