1 13 31
###############################
#p   b* *    1 * 2 *  * * *   #
# # # #*# # #*  # # # #*#*#*# #
# x*     **   *  1   * 2 * f* #
# # # # # #*# # #*#*# # # # #*#
#      *    x **  *  *   1    #
# # # # # # # # # #*# #*# # # #
#*  *      *  *      *        #
# # # # #*# # # #*#*# # # # # #
#*    **  *       *       s   #
# #*# # # # # # #*# # # # # # #
#          1*   *  *          #
###############################