1 13 31
###############################
#p   * *  * 2  *   *  *   *   #
# # # #*# # #*# # # # #*# #*# #
# x* 3    *    *     *   *  * #
# # # # # #*# # #*#*# # # # #*#
# * s  *  3   **  *  *        #
# # # # # # # # # #*# #*# # # #
#    1  *  *  *      *        #
# # # # #*# # # #*#*# # # # # #
#     **  *       *       1   #
# #*# # # # # # #*# # # # # # #
#           *   *  *          #
###############################