1 13 31
###############################
#p   2* *    1 * 2 *  * * *   #
# *   #*# # #*      #  *#*#*# #
# x*     **   *  1   * 2 * f* #
# #   # #  *# # #* *    # # #*#
#      *    x **  *  *   1    #
# # # # # # # # # #*#  *# # # #
#*  *      *  *b     *        #
#     # #*#   # #*#*# # # # # #
#*    **  *       *       s   #
#  *# # # # # # #*#   # # # # #
#          1*   *  *          #
###############################