2 13 31
###############################
#p   * *  *    *   *  * * *   #
# # # #*# # #*# # # # #*#*#*# #
#  * 4   **    *     *   * s* #
# # # # # #*# # #*#*# # # # #*#
# *    *      **  *  *        #
# # # # # # # # # #*# #*# # # #
#       *  *  * 2    *        #
# # # # #*# # # #*#*# # # # # #
#     **  *   x   *       1   #
# #*# # # # # # #*# # # # # # #
#        5  *   *  *          #
###############################