1 13 31
###############################
#p  1  ** *    * 2 *  * * *   #
# # # #*# # #*#*# # # #*#*#*# #
# x*     ***  *  1   * 2 * b* #
# # # # # #*# # #*#*# # # # #*#
#     f    x **  *  *   1     #
# # # # # # # # # #*# #*# # # #
#*  *      *  *      *        #
# # # # #*# # # #*#*# # # # # #
#*    **  *       *       s   #
# #*# # # # # # #*# # # # # # #
#           *   *  *          #
###############################