1 13 31
###############################
#p  wF *  * 1  *   *  *   *   #
# # # #*# # #*# # # # #*# #*# #
# d*      *    *     *   *  * #
# # # # # #*# # #*#*# # # # #*#
# B f  *  3   **  *  *        #
# # # # # # # # # #*# #*# # # #
#      *  *  *  2    *   4    #
# # # # #*# # # #*#*# # # # # #
#     **  *       *       1   #
# #x# # # # # # #*# # # # # # #
#        5  *   *  *          #
###############################