1 13 31
###############################
#p   s* *      * 2 *  * * *   #
# *   #*# # #*      #  *#*#*# #
# x*   1 **   *  1   * 2 * f* #
# #   # #  *# # #* *    # # #*#
#   2  *    x **  *  *   1    #
# # # # # # # # # #*#  *# # # #
#*  *      *  *b     *        #
#     # #*#   # #*#*# # # # # #
#*    **  *       *           #
#  *# # # # # # #*#   # # # # #
#          1*   *  *3         #
###############################