3 13 31
###############################
#p   * *  *  2 *   *  * * *   #
# # # #*# # #*# # # # #*#*#*# #
#  *     **   * 1    *   *  * #
# # # # # #*# # #*#*# # # # #*#
#      *    x **  *  *        #
# # # # # # # # # #*# #*# # # #
#       *  *  *b     *        #
# # # # #*# # # #*#*# # # # # #
#  1  **  *       *           #
# #*# # # # # # #*# # # # # # #
#       2   *   *  *          #
###############################