1 13 31
###############################
#p  Fw *  * 1  *   *  *   *   #
# # # #*# # #*# # # # #*# #*# #
# d*      *    *     *   *  * #
# # # # # #*# # #*#*# # # # #*#
# B s  *  3   **  *  *        #
# # # # # # # # # #*# #*# # # #
#    2  *  *  *      *        #
# # # # #*# # # #*#*# # # # # #
#     **  *       *       1   #
# #x# # # # # # #*# # # # # # #
#           *   *  *          #
###############################