1 13 31
###############################
#p    ** *     * 2 *  * * *   #
# # # #*# # #*#*# # # #*#*#*# #
# x*     ***  *  1   * 2 * b* #
# # # # # #*# # #*#*# # # # #*#
#     f  1 x **  *  *   1     #
# # # # # # # # # #*# #*# # # #
#*  *      *  *      *        #
# # # # #*# # # #*#*# # # # # #
#*    **  *       *       s   #
# #*# # # # # # #*# # # # # # #
#           *   *  *          #
###############################