1 13 31
###############################
#p  wF *  * 1  *   *  *   *   #
# # # #*# # #*# # # # #*# #*# #
# d*      *    *     *   *  * #
# # # # # #*# # #*#*# # # # #*#
# B f  *      **  *  *        #
# # # # # # # # # #*# #*# # # #
#      *  *  *  2    *   4    #
# # # # #*# # # #*#*# # # # # #
#     **  *       *       1   #
# #x# # # # # # #*# # # # # # #
#          3*   *  *          #
###############################